30 19
0 0 
1 0 0 0 0 1 1 1 1 1 1 1 1 1 1 1 1 1 1 1 1 1 1 1 1 1 1 1 1 1
1 0 0 0 0 3 2 0 0 0 0 0 0 0 0 0 0 0 0 0 0 0 0 0 0 0 0 0 1 1
1 0 0 0 0 2 3 0 0 0 0 0 0 0 0 0 0 0 0 0 0 0 0 0 0 0 0 0 1 1
1 0 0 0 0 3 2 0 0 0 0 0 0 0 0 0 0 0 0 0 0 0 0 0 0 0 0 0 1 1
1 0 0 0 0 2 3 0 0 0 0 0 0 0 0 0 0 0 0 0 0 0 0 0 0 0 0 0 1 1
1 0 0 0 0 3 2 0 0 0 0 0 0 0 0 0 0 0 0 0 0 0 0 0 0 0 0 0 1 1 
1 0 0 0 0 2 3 0 0 0 0 0 0 0 0 0 0 0 0 0 0 0 0 0 0 0 0 0 1 1
1 0 0 0 0 3 2 0 0 0 0 0 0 0 0 0 0 0 0 0 0 0 0 0 0 0 0 0 1 1
1 0 0 0 0 2 3 0 0 0 0 0 0 0 0 0 0 9 0 0 0 0 0 0 0 0 0 0 1 1
1 0 0 0 0 3 2 0 0 0 0 0 0 0 0 0 14 14 14 0 0 0 0 0 0 0 0 0 1 1
1 0 0 0 0 2 3 0 0 0 0 0 0 0 0 14 15 16 15 14 0 0 0 0 0 0 0 0 1 1
1 0 0 0 0 3 2 0 0 0 0 0 0 0 14 16 15 16 15 16 14 0 0 0 0 0 0 0 1 1
1 0 0 0 0 2 3 0 0 0 0 0 0 14 15 16 15 16 15 16 15 14 0 0 0 0 0 0 1 1
1 0 0 0 0 3 2 0 0 0 0 0 14 16 15 16 15 16 15 16 15 16 14 0 0 0 0 0 1 1
1 0 0 0 0 2 3 0 0 0 0 14 15 16 15 16 15 16 15 16 15 16 15 14 0 0 0 0 6 5
1 0 0 0 0 0 0 0 0 4 14 16 15 16 15 16 15 16 15 16 15 16 15 16 14 0 0 0 6 5
1 0 0 0 0 0 0 0 0 14 15 16 15 16 15 16 15 16 15 16 15 16 15 16 15 14 0 0 6 5
1 1 1 1 1 1 1 1 1 1 1 1 1 1 1 1 1 1 1 1 1 1 1 1 1 1 1 1 1 1
1 1 1 1 1 1 1 1 1 1 1 1 1 1 1 1 1 1 1 1 1 1 1 1 1 1 1 1 1 1

