30 20
0 0 
1 1 0 0 1 1 1 1 1 1 1 1 1 1 1 1 1 1 1 1 1 1 1 1 1 1 1 1 1 1
1 0 0 0 0 0 0 0 6 0 0 0 0 0 0 3 0 0 0 0 0 0 0 7 0 0 0 0 6 5
1 0 0 0 0 0 0 0 6 0 0 0 0 0 0 7 0 0 0 0 0 0 0 7 0 0 0 0 6 5
1 0 0 0 0 4 0 0 6 0 0 0 0 0 0 7 0 0 0 0 4 0 0 7 0 0 0 0 6 5
1 7 7 7 7 3 3 3 3 3 3 3 6 6 3 3 3 3 3 3 3 3 3 3 6 6 3 3 1 1
1 0 0 0 0 0 3 0 0 0 0 0 0 0 0 3 0 0 0 0 0 3 0 0 0 0 0 0 1 1
1 0 0 0 0 0 6 0 0 0 0 0 0 0 0 7 0 0 0 0 0 3 0 0 0 0 0 0 1 1
1 11 0 0 0 0 6 0 0 0 0 0 0 0 0 7 0 0 0 0 0 3 0 0 0 11 0 0 1 1
1 0 0 0 0 0 3 0 0 0 0 0 0 0 0 3 0 0 0 0 0 3 4 0 0 0 0 0 1 1
1 0 0 0 0 0 3 0 0 0 0 0 0 0 0 3 0 0 0 0 4 3 0 11 0 0 0 0 1 1
1 3 3 0 0 3 3 3 3 3 6 6 3 3 3 3 3 6 6 6 3 3 0 0 0 0 0 3 1 1
1 0 0 0 0 0 3 0 0 0 0 0 0 0 0 3 0 0 0 0 0 7 0 0 0 0 3 3 1 1
1 0 0 0 0 0 6 0 0 0 0 0 0 0 0 3 0 0 0 0 0 7 0 0 0 3 3 3 1 1
1 4 0 0 0 0 6 0 0 0 0 0 0 0 0 3 0 0 0 0 0 7 0 0 3 3 3 3 1 1
1 0 3 0 0 3 3 0 0 3 3 3 0 0 0 3 0 4 0 0 0 3 0 3 3 3 3 3 1 1
1 0 0 0 0 0 0 0 0 0 0 0 0 0 0 0 0 0 3 0 0 0 0 0 0 0 0 0 1 1
1 0 0 0 0 0 0 0 0 0 0 0 0 0 0 0 0 0 0 0 0 0 0 0 0 0 0 0 1 1
1 8 8 8 8 8 8 8 8 8 8 8 8 8 8 8 8 8 8 8 8 8 8 8 8 8 8 8 1 1
1 1 1 1 1 1 1 1 1 1 1 1 1 1 1 1 1 1 1 1 1 1 1 1 1 1 1 1 1 1
1 1 1 1 1 1 1 1 1 1 1 1 1 1 1 1 1 1 1 1 1 1 1 1 1 1 1 1 1 1
