30 20
0 0 
1 0 0 0 0 0 1 1 1 1 1 1 1 1 1 1 1 1 1 1 1 1 1 1 1 1 1 1 1 1
1 0 0 0 0 0 0 0 0 0 0 0 0 0 0 0 0 0 0 0 0 0 0 0 6 0 0 0 1 1
1 0 0 0 0 0 0 0 0 0 0 0 0 0 0 0 0 0 0 0 0 0 0 0 6 0 0 0 1 1
1 0 0 0 0 0 0 0 0 0 0 0 0 0 0 0 0 0 0 0 0 0 0 0 6 0 0 4 1 1
1 0 0 0 0 0 0 0 0 0 0 0 0 0 0 0 0 0 0 0 0 0 0 7 11 11 11 3 1 1
1 0 0 0 0 0 0 0 0 0 0 0 0 0 0 0 0 0 0 0 0 0 7 7 0 0 0 0 1 1 
1 0 0 0 0 0 0 0 0 0 0 0 0 0 0 0 0 0 0 0 7 7 0 0 0 0 0 0 1 1
1 0 3 0 0 0 6 0 0 0 0 0 0 0 0 0 4 0 0 7 0 0 0 0 0 0 0 0 1 1
1 0 3 0 0 0 6 0 0 0 0 0 0 0 0 0 11 11 11 7 0 0 0 0 6 6 6 6 1 1
1 0 3 0 0 4 6 0 0 0 0 0 0 0 0 0 0 0 0 6 0 0 0 3 0 0 0 0 1 1
1 0 3 3 3 3 3 0 0 0 0 0 0 0 0 0 0 0 0 7 0 0 0 3 0 0 0 0 1 1
1 0 0 0 0 0 0 0 0 0 0 0 0 0 0 0 0 0 0 7 0 0 0 3 0 0 0 0 1 1
1 0 0 0 0 0 0 0 3 7 7 7 0 0 6 0 0 0 0 6 6 0 0 3 0 0 0 0 1 1
1 0 0 0 0 0 0 0 3 0 0 0 0 0 0 0 0 0 0 0 0 0 0 3 0 0 0 0 1 1
1 0 0 0 0 0 0 0 3 0 0 0 6 0 0 0 6 6 0 0 0 0 0 3 0 0 0 6 0 5
1 0 0 0 0 0 0 0 3 4 0 0 0 0 0 0 0 0 0 0 0 0 0 3 0 0 0 6 0 5
1 8 8 8 8 8 8 8 3 3 3 3 8 8 8 8 8 8 8 8 8 8 8 3 3 3 3 3 1 1
1 1 1 1 1 1 1 1 1 1 1 1 1 1 1 1 1 1 1 1 1 1 1 1 1 1 1 1 1 1
1 1 1 1 1 1 1 1 1 1 1 1 1 1 1 1 1 1 1 1 1 1 1 1 1 1 1 1 1 1
1 1 1 1 1 1 1 1 1 1 1 1 1 1 1 1 1 1 1 1 1 1 1 1 1 1 1 1 1 1
